35 25
1 1 5 1 1 5 1 1 5 1 1 5 1 1 5 1 1 5 1 1 5 1 1 5 1 1 1 1 1 1 1 1 1 1 1
1 0 0 0 1 0 0 0 0 0 1 0 0 0 0 0 2 2 2 2 2 0 0 0 3 3 3 3 3 3 3 3 1 1 1
4 0 1 0 1 0 1 1 1 0 1 0 1 1 1 0 2 0 0 0 2 0 2 0 3 0 0 0 0 0 0 0 0 0 4
1 0 1 0 0 0 0 0 1 0 0 0 1 0 0 0 2 0 2 0 2 0 2 0 3 0 3 3 3 0 3 3 3 0 1
1 0 1 1 1 1 1 0 1 1 1 1 1 0 1 1 2 0 2 0 0 0 2 0 0 0 3 0 0 0 3 0 0 0 1
4 0 0 0 0 0 0 0 0 0 0 0 0 0 0 0 2 0 2 2 2 2 2 0 3 0 3 0 3 0 3 0 3 0 4
1 1 1 0 1 1 1 1 1 0 1 1 1 1 1 0 2 0 0 0 0 0 0 0 3 0 0 0 3 0 0 0 3 0 1
1 0 0 0 1 0 0 0 0 0 1 0 0 0 1 0 2 2 2 0 2 2 2 2 3 3 3 0 3 3 3 0 3 0 1
4 0 1 1 1 0 1 1 1 1 1 0 1 0 1 0 0 0 0 0 0 0 0 0 0 0 0 0 0 0 0 0 3 0 4
1 0 0 0 0 0 0 0 0 0 0 0 1 0 1 1 1 1 1 0 1 1 1 1 1 1 1 1 1 1 1 0 3 0 1
1 1 1 1 1 1 1 0 1 1 1 1 1 0 0 0 0 0 0 0 0 0 0 0 0 0 0 0 0 0 0 0 0 0 1
4 0 0 0 0 0 0 0 0 0 0 0 1 1 1 1 1 1 1 1 1 1 1 1 1 1 1 1 1 1 1 1 1 1 4
1 0 1 1 1 0 1 1 1 1 1 0 0 0 0 0 0 0 0 0 0 0 0 0 0 0 0 0 0 0 0 0 0 0 1
1 0 1 0 0 0 1 0 0 0 1 1 1 1 1 0 1 1 1 1 1 0 1 1 1 1 1 0 1 1 1 1 1 0 1
4 0 1 0 1 0 1 0 1 0 0 0 0 0 0 0 6 0 0 0 1 0 1 0 0 0 1 0 1 0 0 0 1 0 4
1 0 0 0 1 0 0 0 1 1 1 1 1 1 1 0 7 0 1 0 1 0 1 0 1 0 1 0 1 0 1 0 1 0 1
1 1 1 1 1 0 1 1 1 0 0 0 0 0 9 0 8 0 1 0 1 0 1 0 1 0 1 0 1 0 1 0 1 0 1
4 0 0 0 0 0 1 0 0 0 1 1 1 0 10 0 1 0 1 0 1 0 1 0 1 0 1 0 1 0 1 0 1 0 4
1 0 1 1 1 1 1 0 1 1 1 0 0 0 1 0 0 0 1 0 0 0 1 0 1 0 1 0 1 0 1 0 1 0 1
1 0 0 0 0 0 0 0 0 0 0 0 1 1 1 1 1 1 1 1 1 1 1 0 1 0 1 0 1 0 1 0 1 0 1
4 1 1 1 1 1 1 1 1 1 1 0 0 0 0 0 0 0 0 0 0 0 0 0 0 0 0 0 0 0 0 0 0 0 4
1 0 0 0 0 0 0 0 0 0 0 0 1 1 1 1 1 1 1 1 1 1 1 1 1 1 1 1 1 1 1 1 1 0 1
1 0 1 1 1 1 1 1 1 1 1 0 0 0 0 0 0 0 0 0 0 0 0 0 0 0 0 0 0 0 0 0 0 0 1
4 0 0 0 0 0 0 0 0 0 0 0 1 1 1 1 1 1 1 1 1 1 1 1 1 1 1 1 1 1 1 1 1 1 4
1 1 5 1 1 5 1 1 5 1 1 5 1 1 5 1 1 5 1 1 5 1 1 5 1 1 5 1 1 5 1 1 5 1 1